TODO means a new icon
FIXME means remaking an icon I'm unhappy with

**——————————————————————— Current Progress ———————————————————————**
/u/cj81499
TODO  Apple Home     - com.apple.Home
TODO  Apple Activity - com.apple.Fitness
TODO  BetaVendor     - com.matchstic.BetaVendor
TODO  CPDD Connect   - com.cpdigitaldarkroom.Connect
TODO  Firefox        - org.mozilla.ios.Firefox + org.mozilla.ios.Focus
TODO  Tidal          - com.aspiro.TIDAL
TODO  Datpiff        - com.datpiff.mobile

FIXME United         - com.united.UnitedCustomerFacingIPhone
FIXME Singapore Air  - com.amadeus.sqmobile
FIXME GILT           - com.gilt.gilt
FIXME Swype          - com.nuance.swype.app
FIXME Settings Icons (They look poopy)

/u/Jacie950
TODO EE - uk.co.ee.MyEE

/u/Kyrios9
TODO MinimaList  - com.davetech.todo
TODO Google keep - com.google.Keep

/u/Mikelightman
TODO Castro 2     - co.supertop.Castro-2
TODO USAA         - com.usaa.UsaaMobile
TODO Weather line - com.offcoast.weatherline
TODO Due          - com.phocusllp.due
TODO MLB at bat   - com.mlb.AtBatUniversal

/u/asoksevil
TODO Pleco Chinese Dictionary - com.pleco.chinesesystem
TODO WordReference Dictionary - com.wordreference.WordReferenceDictionary
TODO Newsify RSS Reader       - com.synsion.Newsify
TODO LinkedIn                 - com.linkedin.LinkedIn
TODO HSBC UK Mobile Banking   - uk.co.hsbc.hsbcukmobilebanking
